3C3333333
333333333
1B41111111111111111111111111
4A00000000000000000000000091
1111111111111111111111111401
1700000000000000000000000081
1041111111111111111111111111
16000000000000000000000000005
11111111111411111111111112111