111111111111121111111111111
500000000000000000000000061
111111111111141111111111401
111111111141333800000000071
1A000000000B333141111111111
104111111111141111111111111
190000000000000000000000005
111111111111111111111111111