3B3333333
333333333
1A111111111111111111111111F1
G900000000000000000000000081
1D11111111111111111111111101
160000000000000000000000007E
1011111111111111111111111111
C5000000000000000000000000004
11111111111111111111111112111